R 980 760
NO ./src/stone.xpm
SO ./src/wood.xpm
WE ./src/mossy.xpm
EA ./src/redbrick.xpm

S ./path_to_the_sprite_texture
F 220,100,0
C 225,30,0

1 1 1 1 1 1 1 1 1 1 1 1 1 1 1 1 1 1 1 1 1 1 1 1 1 1 1 1 1
1 0 0 0 0 0 0 0 0 0 1 1 0 0 2 2 0 0 0 0 0 3 3 3 3 3 3 3 1
1 0 1 1 0 0 0 0 0 1 1 1 0 0 2 2 0 0 2 0 0 2 2 2 2 2 0 W 1
1 3 3 3 3 3 3 3 3 1 1 1 0 0 2 2 0 0 2 0 0 3 3 3 3 3 3 3 1
1 0 0 0 0 0 0 0 0 0 0 0 0 0 0 0 0 0 0 0 0 0 0 0 0 0 0 0 1
1 1 1 1 1 1 1 1 1 1 1 1 1 1 1 1 1 1 1 1 1 1 1 1 1 1 1 1 1