R 720 480
NO ./src/wall_c1.xpm
SO ./src/wall_c2.xpm
WE ./src/wall_c3.xpm
EA ./src/wall_c4.xpm

S ./path_to_the_sprite_texture
F 220,100,0
C 225,30,0

1 1 1 1 1 1 1 1 1 1 1 1 1 1 1
1 3 4 4 3 3 4 4 4 3 3 4 3 4 1
1 0 0 0 0 3 4 2 4 3 0 0 0 0 1
1 0 0 0 0 3 4 2 2 3 0 0 0 0 1
1 0 0 0 0 0 0 0 0 0 0 0 0 0 1
1 2 4 0 0 0 0 0 0 0 0 2 4 0 1
1 0 0 0 0 0 0 0 0 0 0 0 0 0 1
1 0 0 0 0 0 3 2 3 0 0 0 0 0 1
1 0 0 0 0 0 3 2 3 0 0 0 0 0 1
1 0 0 0 0 0 3 2 3 0 0 0 0 0 1
1 0 0 0 0 0 3 2 3 0 0 0 0 0 1
1 2 3 3 2 0 3 N 3 0 2 3 3 2 1
1 1 1 1 1 1 1 1 1 1 1 1 1 1 1
