R 852 480
NO ./src/stone.xpm
SO ./src/wood.xpm
WE ./src/mossy.xpm
EA ./src/redbrick.xpm

S ./path_to_the_sprite_texture
F 220,100,0
C 225,30,0

1 1 1 1 1 1 1 1 1 1 1 1 1 1 1
1 3 2 2 3 3 2 2 2 3 3 2 3 2 1
1 0 0 0 0 3 2 2 2 3 0 0 0 0 1
1 0 0 0 0 3 2 2 2 3 0 0 0 0 1
1 0 0 0 0 0 0 0 0 0 0 0 0 0 1
1 2 2 0 0 0 0 0 0 0 0 2 2 0 1
1 0 0 0 0 0 0 0 0 0 0 0 0 0 1
1 0 0 0 0 0 3 2 3 0 0 0 0 0 1
1 0 0 0 0 0 3 2 3 0 0 0 0 0 1
1 0 0 0 0 0 3 2 3 0 0 0 0 0 1
1 0 0 0 0 0 3 2 3 0 0 0 0 0 1
1 2 3 3 2 0 3 N 3 0 2 3 3 2 1
1 1 1 1 1 1 1 1 1 1 1 1 1 1 1
